*************
S *         *
* ******* ***
*   *   *   *
*** * * *** *
* * * *   * *
* * * *** * *
*     *     E
*************